NO textures/Wall_wood.xpm
SO textures/Wall_paper.xpm
WE textures/Wall_stone.xpm
EA textures/Wall_Castle.xpm
DD textures/Door.xpm

F         50,50,50
C 150,150,255

111111111111111111111
111111111111111111111
111110101011111110001
100010100010000010001
111110101111101011101
100000101000101000001
101111101011101111111
101000001010100000101
101011111010111110101
101010001010100010101
101110101010101010101
100000101010001010001
111111101011111011101
100000101000100010001
101110101110101110111
101000100000100010101
1010111111D1111010101
100010000000000010001
1   1               1
1N10D0001000000000001
111111111111111111111




                       









                    