NO textures/simonkraft/north.xpm
SO textures/simonkraft/south.xpm
WE textures/simonkraft/west.xpm
EA textures/simonkraft/wet_sponge.xpm

F 0,0,0
C 0,0,0

1 1111
111111
1
1N000
10100
