NO textures/simonkraft/wet_sponge.xpm
SO textures/simonkraft/wet_sponge.xpm
WE textures/simonkraft/wet_sponge.xpm
EA textures/simonkraft/wet_sponge.xpm
F 164,169,20
C 153,204,255

 1111111 
111111111
1111S0001
111100001
111110001
 1111111 
