11111111
1110N011
11100011
11100011
10000111
11111111