NO textures/simonkraft/wet_sponge.xpm
SO textures/simonkraft/wet_sponge.xpm
WE textures/simonkraft/wet_sponge.xpm
EA textures/simonkraft/wet_sponge.xpm
F 164,169,20
C 153,204,255

  11111111  
1111111111111
111111111111
1111S000111
11110000111
111111111111
1111111111111
  11111111  
