NO textures/simonkraft/wet_sponge.xpm
SO textures/simonkraft/wet_sponge.xpm
WE textures/simonkraft/wet_sponge.xpm
EA textures/simonkraft/wet_sponge.xpm
F 164,169,20
C 153,204,255

11111  111111
111111111111
1111S0001 1
 110000111
11110110001
111111111111
